Het kanaal,20,10,5;0,5;19
0,0,0,0,0,0,0,0,0,0
0,0,0,0,0,0,0,0,0,0
0,0,0,0,0,0,0,0,0,0
2,0,0,3,0,0,3,0,0,2
2,0,0,0,0,0,0,0,0,2
2,0,0,0,3,3,0,0,0,2
0,0,0,0,0,0,0,0,0,0
3,3,3,0,0,0,0,3,3,3
1,1,1,1,1,1,1,1,1,1
4,4,4,4,1,1,4,4,4,4
1,1,1,1,1,1,1,1,1,1
3,3,3,0,0,0,0,3,3,3
0,0,0,0,0,0,0,0,0,0
2,0,0,0,3,3,0,0,0,2
2,0,0,0,0,0,0,0,0,2
2,0,0,3,0,0,3,0,0,2
0,0,0,0,0,0,0,0,0,0
0,0,0,0,0,0,0,0,0,0
0,0,0,0,0,0,0,0,0,0
0,0,0,0,0,0,0,0,0,0